...###
..####.##11
.########11
#########1#
###########
###########
..#########
.####..####
.##....###
.#222####
.#22####