...PPP
..#P##.###C
.##########
#######P#W#
###########
TTT########
..#########
.####..####
.##....###
.###W####
.#C###T#